WORLD_PATH "data/world"
TILE_PATH WORLD_PATH+"/tiles"

SIZE 10x10
MAP
213,213,213,213,213,213,213,213,213,213
213,237,237,237,237,237,237,237,237,213
213,237,237,237,237,237,237,237,237,213
213,237,237,237,237,237,237,237,237,213
213,237,237,237,237,237,237,237,237,213
213,237,237,237,237,237,237,237,237,213
213,237,237,237,237,237,237,237,237,213
213,237,237,237,237,237,237,237,237,213
213,237,237,237,237,237,237,237,237,213
213,213,213,213,208,210,213,213,213,213
END

OBJECTS

OBJECT gameObjects.TrapDoor
POSITION
X 192
Y 192

END

COMPLEX_TILES
